11111111111111
1N00000P1C00C1
100C1000100001
100010C01N0001
10001000111001
1000100CC00001
100C001010C001
1N000C1C10E001
11111111111111
